1111
1PE1
10C1
10C1
10P1
1111
